00 00 00 00 00 00 00 00 00 00 00 00 00 00 00 00 00 00 00 00 00 00 00 00 00
00 00 00 00 00 00 00 00 00 00 00 00 00 00 00 00 00 00 00 00 00 00 00 00 00
00 00 00 00 00 00 00 00 00 00 00 00 00 00 00 00 00 00 00 00 00 00 00 00 00
00 00 00 03 03 03 03 03 03 03 03 03 03 03 03 03 03 03 00 00 00 03 03 03 03
00 00 00 03 00 00 00 00 00 00 00 00 03 03 03 00 00 00 00 00 00 00 00 00 00 
00 00 00 03 00 00 00 00 00 00 00 00 03 03 03 00 00 00 00 00 00 00 00 00 00 
00 00 00 03 00 00 00 03 03 00 00 00 03 03 03 00 00 00 00 00 00 00 00 00 00
00 00 00 03 00 00 00 03 03 00 00 00 03 03 03 00 00 00 00 00 00 00 00 00 00
00 00 00 03 00 00 00 03 03 00 00 00 03 03 03 00 00 00 00 00 00 00 03 03 03
00 00 00 03 00 00 00 03 03 00 00 00 03 03 03 00 00 00 00 00 00 00 03 03 03
00 00 00 03 00 00 00 03 03 00 00 00 00 00 00 00 00 00 00 00 00 00 03 03 03
00 00 00 03 00 00 00 03 03 00 00 00 00 00 00 00 00 00 00 00 00 00 03 03 03
00 00 00 03 00 00 00 03 03 00 00 00 00 00 03 03 03 03 00 00 00 00 03 03 03
00 00 00 03 00 00 00 03 03 00 00 00 00 03 03 03 03 03 00 00 00 00 03 03 03
00 00 00 03 00 00 00 03 03 00 00 00 00 03 03 00 00 00 00 00 00 00 00 00 00
00 00 00 03 00 00 00 03 03 00 00 00 00 03 03 00 00 00 00 00 03 03 03 00 00 
00 00 00 03 00 00 00 03 03 00 00 00 00 03 03 00 00 00 00 00 03 03 03 00 00 
00 00 00 03 00 00 00 00 00 00 00 00 00 00 03 03 03 00 00 00 03 03 03 00 00 
00 00 00 03 00 00 00 00 00 00 00 00 00 00 03 03 03 03 03 03 03 03 03 00 00
00 00 00 03 00 00 00 00 00 00 00 00 00 00 03 03 03 03 03 03 03 03 03 00 00
00 00 00 00 00 00 00 00 00 00 00 00 00 00 03 03 03 03 03 03 03 03 03 00 00
00 00 00 00 00 00 00 00 00 00 00 00 00 00 00 03 03 00 00 00 00 03 03 00 00 
00 00 00 00 00 00 00 00 00 00 00 00 00 00 00 03 03 00 00 00 00 03 03 00 00 
03 03 03 03 03 03 03 00 00 00 00 00 00 00 00 00 00 00 00 00 00 00 00 00 00
03 03 03 03 03 03 03 00 00 00 00 00 00 00 00 00 00 00 00 00 00 00 00 00 03